####################
.................#..
....................
....................
....................
...................
.@..................
....................
####################