###########...@.....###########
###########.........###########
###########.........###########
###########..#......###########
###########.......#.###########
###########.........###########
###########...#.#...###########
###########.........###########
###########.........###########
###########..#......###########
###########....#....###########
###########.........###########
###########......#..###########
############........###########
###########..#......###########
###########........############
###########.........###########
###########.....#...###########
###########........###########
###########.#.......###########
