###########.......@...........###########
###########...................###########
###########............####...###########
###########.####..............###########
###########...................###########
###########...................###########
###########...................###########
###########............####...###########
###########.####..............#############
###########...................###########
###########..............###############
###########...................###########
###########.......####.........###############
###########...................###########
###############................###########
###########....................###########
###########...................###########
###########....####............###########
###########..............###############
###########..####...####..#########