###########..@###########
###########...###########
#############.###########
###########...###########
###########...###########
###########...###########
###########.############
###########...###########
###########...###########
###########...###########
############..###########
###########...###########
###########...###########
###########.############
###########...###########
###########...###########
###########...###########
############..###########
###########...###########
###########...###########