###########...@...............###########
###########...................###########
###########...................###########
###########................#..###########
###########...................###########
###########.#....#.####.#....#############
###########...................###########
###########...#...........#...###########
###########.#....###...###..###########
###########.........#.......#...###########
###########....#..........#....###########
###########....#...#...#..#...#...###########
###########...#.....#......#...###########
###########...#............#..###########
###########............#.......###########
###########.#....#.####.#....#############
###########...................###########
###########...#.....#......#...###########
###########...#.....#......#..###########
###########...#.....#......#...###########