###########...@.....###########
###########.........###########
###########.........###########
##############......###########
###########.......#############
###########.........###########
###########...#.#...###########
###########.........###########
###########.........###########
###########..#......###########
###########.........###########
###########...#.#..###########
###############.#...###########
###########...#.#.#############
###########...#.#...###########
###########...#.#...###########
###########...#.#..############
###########...####...###########
###########........###########
###########........###########