###########...@.......###########
###########...........###########
###########...........###########
###########...........###########
###########...........###########
###########........#..###########
###########........###########
###########...#........###########
###########.....#.....###########
###########..........###########
###########..#........###########
##############.........###########
###########.......###########
###########.....###....###########
###########.............###########
###########............###########
###########...#.........###########
###########.#..........##########
##############.........#########
##############..#..#..#.#########