###########...@...###########
###########.......###########
############......###########
###########.#.....###########
###########..#....###########
###########...#...###########
###########.......############
###########.......#########
###########......############
###########.....#.###########
###########....#.###########
###########...#...###########
############......###########
###########.#.....###########
###########..#....###########
###########...#...############
###########.......###########
###########......#############
###########.....#.#########
###########....#..#########