###########...@.......###########
###########...........###########
###########...........###########
###########...........###########
###########...........###########
###########..#######..###########
###########........#..###########
###########........###########
###########...........###########
###########...........###########
###########............###########
###########...........###########
##############.........###########
###########.......###.###########
###########.....#......###########
###########...#........###########
###########.....#...#...###########
###########..#....#.....###########
###########........#...###########
###########..#..#..#.....#########