###########...@.....#..###########
###########...........###########
###########.......#...#.###########
###########........#...###########
###########..#....#.#..###########
###########.......#.....###########
###########..#....#.#..#.###########
###########...........###########
###########..........###########
###########.......###########
###########.#.........###########
###########..#.........###########
###########.#...........###########
###########............###########
###########.............###########
###########..#..........###########
###########............###########
###########...#.#....#....#########
###########...#.#....#....#########
###########...#.#....#....#########