###########.@.......###########
###########..........#############
##########.........###########
#########.........###########
########.........###########
#######.........###########
#########.........###########
###########.........###########
#############.........###########
##############.........#########
###############.........#########
##################.......###########
#################..........#############
###############...........########
#############............############
###########............#######
#########.............#######
##########..#........###########
###########.........###########
############.......############